####################
#     Y  Y  #   #  #
#     Y  Y  #      #
#  *  Y     #      #
#           #   #  #
#           #   #  #
#               #  #
###############X#  #
#################  #
#                  #
F                  #
####################
