################################
#                              #
#   *                          #
#                              #
#     ### ### ### ### ###      #
#      #   #   #   #   #       #
#      #   #   #   #   #       #
#      #   #   #   #   #       #
#                              #
#                              #
########       #################
#                              #
F                              #
#                              #
#                              #
################################
