################################
#                              #
#                              #
#                              #
#                              #
#        #####                 #
#        #####                 #
#        #####                 #
#        #####                 #
#        #####                 #
#        #####                 #
#        #####                 #
#                              #
#                              #
#                              #
################################
