################################
#                              #
#                              #
#                              #
#                              #
#                       ########
#                       ########
#                       ########
#             *         ########
#                       ########
#                       ########
#                       ########
#                              #
#                              #
#                              #
################################
