################################
#       *                      #
#                              #
#                             c#
#                              #
####                    ########
###########            c########
#                       ########
#                       ########
#                      c########
#                       ########
#                       ########
#                              #
#                              #
#                              #
################################
