###############################
#       *                      #
#                              #
#                             c#
#                              #
#                       ########
#                      c########
#                       ########
#                       ########
#                      c########
#                       ########
#                       #######
#                              #
#                              #
#                              #
################################
